/	wiki.views.article.ArticleView	wiki:root
/<article_id>/	wiki.views.article.ArticleView	wiki:get
/<article_id>/delete/	wiki.views.article.Delete	wiki:delete
/<article_id>/deleted/	wiki.views.article.Deleted	wiki:deleted
/<article_id>/edit/	wiki.views.article.Edit	wiki:edit
/<article_id>/history/	wiki.views.article.History	wiki:history
/<article_id>/move/	wiki.views.article.Move	wiki:move
/<article_id>/plugin/<slug>/	wiki.views.article.Plugin	wiki:plugin
/<article_id>/plugin/attachments/	wiki.plugins.attachments.views.AttachmentView	wiki:attachments_index
/<article_id>/plugin/attachments/add/<attachment_id>/	wiki.plugins.attachments.views.AttachmentAddView	wiki:attachments_add
/<article_id>/plugin/attachments/change/<attachment_id>/revision/<revision_id>/	wiki.plugins.attachments.views.AttachmentChangeRevisionView	wiki:attachments_revision_change
/<article_id>/plugin/attachments/delete/<attachment_id>/	wiki.plugins.attachments.views.AttachmentDeleteView	wiki:attachments_delete
/<article_id>/plugin/attachments/download/<attachment_id>/	wiki.plugins.attachments.views.AttachmentDownloadView	wiki:attachments_download
/<article_id>/plugin/attachments/download/<attachment_id>/revision/<revision_id>/	wiki.plugins.attachments.views.AttachmentDownloadView	wiki:attachments_download
/<article_id>/plugin/attachments/history/<attachment_id>/	wiki.plugins.attachments.views.AttachmentHistoryView	wiki:attachments_history
/<article_id>/plugin/attachments/replace/<attachment_id>/	wiki.plugins.attachments.views.AttachmentReplaceView	wiki:attachments_replace
/<article_id>/plugin/attachments/search/	wiki.plugins.attachments.views.AttachmentSearchView	wiki:attachments_search
/<article_id>/preview/	wiki.views.article.Preview	wiki:preview
/<article_id>/revision/change/<revision_id>/	wiki.views.article.ChangeRevisionView	wiki:change_revision
/<article_id>/revision/merge/<revision_id>/	wiki.views.article.MergeView	wiki:merge_revision
/<article_id>/settings/	wiki.views.article.Settings	wiki:settings
/<article_id>/source/	wiki.views.article.Source	wiki:source
/<path>	wiki.views.article.ArticleView	wiki:get
/<path>_create/	wiki.views.article.Create	wiki:create
/<path>_delete/	wiki.views.article.Delete	wiki:delete
/<path>_deleted/	wiki.views.article.Deleted	wiki:deleted
/<path>_dir/	wiki.views.article.Dir	wiki:dir
/<path>_edit/	wiki.views.article.Edit	wiki:edit
/<path>_history/	wiki.views.article.History	wiki:history
/<path>_move/	wiki.views.article.Move	wiki:move
/<path>_plugin/<slug>/	wiki.views.article.Plugin	wiki:plugin
/<path>_plugin/attachments/	wiki.plugins.attachments.views.AttachmentView	wiki:attachments_index
/<path>_plugin/attachments/add/<attachment_id>/	wiki.plugins.attachments.views.AttachmentAddView	wiki:attachments_add
/<path>_plugin/attachments/change/<attachment_id>/revision/<revision_id>/	wiki.plugins.attachments.views.AttachmentChangeRevisionView	wiki:attachments_revision_change
/<path>_plugin/attachments/delete/<attachment_id>/	wiki.plugins.attachments.views.AttachmentDeleteView	wiki:attachments_delete
/<path>_plugin/attachments/download/<attachment_id>/	wiki.plugins.attachments.views.AttachmentDownloadView	wiki:attachments_download
/<path>_plugin/attachments/download/<attachment_id>/revision/<revision_id>/	wiki.plugins.attachments.views.AttachmentDownloadView	wiki:attachments_download
/<path>_plugin/attachments/history/<attachment_id>/	wiki.plugins.attachments.views.AttachmentHistoryView	wiki:attachments_history
/<path>_plugin/attachments/replace/<attachment_id>/	wiki.plugins.attachments.views.AttachmentReplaceView	wiki:attachments_replace
/<path>_plugin/attachments/search/	wiki.plugins.attachments.views.AttachmentSearchView	wiki:attachments_search
/<path>_preview/	wiki.views.article.Preview	wiki:preview
/<path>_revision/change/<revision_id>/	wiki.views.article.ChangeRevisionView	wiki:change_revision
/<path>_revision/merge/<revision_id>/	wiki.views.article.MergeView	wiki:merge_revision
/<path>_search/	wiki.views.article.SearchView	wiki:search
/<path>_settings/	wiki.views.article.Settings	wiki:settings
/<path>_source/	wiki.views.article.Source	wiki:source
/_accounts/login/	wiki.views.accounts.Login	wiki:login
/_accounts/logout/	wiki.views.accounts.Logout	wiki:logout
/_accounts/settings/	wiki.views.accounts.Update	wiki:profile_update
/_accounts/sign-up/	wiki.views.accounts.Signup	wiki:signup
/_admin/	wiki.views.deleted_list.DeletedListView	wiki:deleted_list
/_plugin/notifications/	wiki.plugins.notifications.views.NotificationSettings	wiki:notification_settings
/_revision/change/<article_id>/<revision_id>/	wiki.views.article.ChangeRevisionView	wiki:change_revision
/_revision/diff/<revision_id>/	wiki.views.article.DiffView	wiki:diff
/_revision/merge/<article_id>/<revision_id>/preview/	wiki.views.article.MergeView	wiki:merge_revision_preview
/_revision/preview/<article_id>/	wiki.views.article.Preview	wiki:preview_revision
/_search/	wiki.views.article.SearchView	wiki:search
/admin/	django.contrib.admin.sites.index	admin:index
/admin/<app_label>/	django.contrib.admin.sites.app_index	admin:app_list
/admin/<url>	django.contrib.admin.sites.catch_all_view
/admin/artefacts/artefactaccesslog/	django.contrib.admin.options.changelist_view	admin:artefacts_artefactaccesslog_changelist
/admin/artefacts/artefactaccesslog/<path:object_id>/	django.views.generic.base.RedirectView
/admin/artefacts/artefactaccesslog/<path:object_id>/change/	django.contrib.admin.options.change_view	admin:artefacts_artefactaccesslog_change
/admin/artefacts/artefactaccesslog/<path:object_id>/delete/	django.contrib.admin.options.delete_view	admin:artefacts_artefactaccesslog_delete
/admin/artefacts/artefactaccesslog/<path:object_id>/history/	django.contrib.admin.options.history_view	admin:artefacts_artefactaccesslog_history
/admin/artefacts/artefactaccesslog/add/	django.contrib.admin.options.add_view	admin:artefacts_artefactaccesslog_add
/admin/artefacts/artefactmeta/	django.contrib.admin.options.changelist_view	admin:artefacts_artefactmeta_changelist
/admin/artefacts/artefactmeta/<path:object_id>/	django.views.generic.base.RedirectView
/admin/artefacts/artefactmeta/<path:object_id>/change/	django.contrib.admin.options.change_view	admin:artefacts_artefactmeta_change
/admin/artefacts/artefactmeta/<path:object_id>/delete/	django.contrib.admin.options.delete_view	admin:artefacts_artefactmeta_delete
/admin/artefacts/artefactmeta/<path:object_id>/history/	django.contrib.admin.options.history_view	admin:artefacts_artefactmeta_history
/admin/artefacts/artefactmeta/add/	django.contrib.admin.options.add_view	admin:artefacts_artefactmeta_add
/admin/auth/group/	django.contrib.admin.options.changelist_view	admin:auth_group_changelist
/admin/auth/group/<path:object_id>/	django.views.generic.base.RedirectView
/admin/auth/group/<path:object_id>/change/	django.contrib.admin.options.change_view	admin:auth_group_change
/admin/auth/group/<path:object_id>/delete/	django.contrib.admin.options.delete_view	admin:auth_group_delete
/admin/auth/group/<path:object_id>/history/	django.contrib.admin.options.history_view	admin:auth_group_history
/admin/auth/group/add/	django.contrib.admin.options.add_view	admin:auth_group_add
/admin/auth/user/	django.contrib.admin.options.changelist_view	admin:auth_user_changelist
/admin/auth/user/<id>/password/	django.contrib.auth.admin.user_change_password	admin:auth_user_password_change
/admin/auth/user/<path:object_id>/	django.views.generic.base.RedirectView
/admin/auth/user/<path:object_id>/change/	django.contrib.admin.options.change_view	admin:auth_user_change
/admin/auth/user/<path:object_id>/delete/	django.contrib.admin.options.delete_view	admin:auth_user_delete
/admin/auth/user/<path:object_id>/history/	django.contrib.admin.options.history_view	admin:auth_user_history
/admin/auth/user/add/	django.contrib.auth.admin.add_view	admin:auth_user_add
/admin/autocomplete/	django.contrib.admin.sites.autocomplete_view	admin:autocomplete
/admin/executions/executionlog/	django.contrib.admin.options.changelist_view	admin:executions_executionlog_changelist
/admin/executions/executionlog/<path:object_id>/	django.views.generic.base.RedirectView
/admin/executions/executionlog/<path:object_id>/change/	django.contrib.admin.options.change_view	admin:executions_executionlog_change
/admin/executions/executionlog/<path:object_id>/delete/	django.contrib.admin.options.delete_view	admin:executions_executionlog_delete
/admin/executions/executionlog/<path:object_id>/history/	django.contrib.admin.options.history_view	admin:executions_executionlog_history
/admin/executions/executionlog/add/	django.contrib.admin.options.add_view	admin:executions_executionlog_add
/admin/executions/pipelinerun/	django.contrib.admin.options.changelist_view	admin:executions_pipelinerun_changelist
/admin/executions/pipelinerun/<path:object_id>/	django.views.generic.base.RedirectView
/admin/executions/pipelinerun/<path:object_id>/change/	django.contrib.admin.options.change_view	admin:executions_pipelinerun_change
/admin/executions/pipelinerun/<path:object_id>/delete/	django.contrib.admin.options.delete_view	admin:executions_pipelinerun_delete
/admin/executions/pipelinerun/<path:object_id>/history/	django.contrib.admin.options.history_view	admin:executions_pipelinerun_history
/admin/executions/pipelinerun/add/	django.contrib.admin.options.add_view	admin:executions_pipelinerun_add
/admin/executions/steprun/	django.contrib.admin.options.changelist_view	admin:executions_steprun_changelist
/admin/executions/steprun/<path:object_id>/	django.views.generic.base.RedirectView
/admin/executions/steprun/<path:object_id>/change/	django.contrib.admin.options.change_view	admin:executions_steprun_change
/admin/executions/steprun/<path:object_id>/delete/	django.contrib.admin.options.delete_view	admin:executions_steprun_delete
/admin/executions/steprun/<path:object_id>/history/	django.contrib.admin.options.history_view	admin:executions_steprun_history
/admin/executions/steprun/add/	django.contrib.admin.options.add_view	admin:executions_steprun_add
/admin/features/artifactmeta/	django.contrib.admin.options.changelist_view	admin:features_artifactmeta_changelist
/admin/features/artifactmeta/<path:object_id>/	django.views.generic.base.RedirectView
/admin/features/artifactmeta/<path:object_id>/change/	django.contrib.admin.options.change_view	admin:features_artifactmeta_change
/admin/features/artifactmeta/<path:object_id>/delete/	django.contrib.admin.options.delete_view	admin:features_artifactmeta_delete
/admin/features/artifactmeta/<path:object_id>/history/	django.contrib.admin.options.history_view	admin:features_artifactmeta_history
/admin/features/artifactmeta/add/	django.contrib.admin.options.add_view	admin:features_artifactmeta_add
/admin/features/executionlog/	django.contrib.admin.options.changelist_view	admin:features_executionlog_changelist
/admin/features/executionlog/<path:object_id>/	django.views.generic.base.RedirectView
/admin/features/executionlog/<path:object_id>/change/	django.contrib.admin.options.change_view	admin:features_executionlog_change
/admin/features/executionlog/<path:object_id>/delete/	django.contrib.admin.options.delete_view	admin:features_executionlog_delete
/admin/features/executionlog/<path:object_id>/history/	django.contrib.admin.options.history_view	admin:features_executionlog_history
/admin/features/executionlog/add/	django.contrib.admin.options.add_view	admin:features_executionlog_add
/admin/features/featureimportlog/	django.contrib.admin.options.changelist_view	admin:features_featureimportlog_changelist
/admin/features/featureimportlog/<path:object_id>/	django.views.generic.base.RedirectView
/admin/features/featureimportlog/<path:object_id>/change/	django.contrib.admin.options.change_view	admin:features_featureimportlog_change
/admin/features/featureimportlog/<path:object_id>/delete/	django.contrib.admin.options.delete_view	admin:features_featureimportlog_delete
/admin/features/featureimportlog/<path:object_id>/history/	django.contrib.admin.options.history_view	admin:features_featureimportlog_history
/admin/features/featureimportlog/add/	django.contrib.admin.options.add_view	admin:features_featureimportlog_add
/admin/features/featuremeta/	django.contrib.admin.options.changelist_view	admin:features_featuremeta_changelist
/admin/features/featuremeta/<path:object_id>/	django.views.generic.base.RedirectView
/admin/features/featuremeta/<path:object_id>/change/	django.contrib.admin.options.change_view	admin:features_featuremeta_change
/admin/features/featuremeta/<path:object_id>/delete/	django.contrib.admin.options.delete_view	admin:features_featuremeta_delete
/admin/features/featuremeta/<path:object_id>/history/	django.contrib.admin.options.history_view	admin:features_featuremeta_history
/admin/features/featuremeta/add/	django.contrib.admin.options.add_view	admin:features_featuremeta_add
/admin/features/featureversion/	django.contrib.admin.options.changelist_view	admin:features_featureversion_changelist
/admin/features/featureversion/<path:object_id>/	django.views.generic.base.RedirectView
/admin/features/featureversion/<path:object_id>/change/	django.contrib.admin.options.change_view	admin:features_featureversion_change
/admin/features/featureversion/<path:object_id>/delete/	django.contrib.admin.options.delete_view	admin:features_featureversion_delete
/admin/features/featureversion/<path:object_id>/history/	django.contrib.admin.options.history_view	admin:features_featureversion_history
/admin/features/featureversion/add/	django.contrib.admin.options.add_view	admin:features_featureversion_add
/admin/jsi18n/	django.contrib.admin.sites.i18n_javascript	admin:jsi18n
/admin/login/	django.contrib.admin.sites.login	admin:login
/admin/logout/	django.contrib.admin.sites.logout	admin:logout
/admin/notebooks/notebookexecution/	django.contrib.admin.options.changelist_view	admin:notebooks_notebookexecution_changelist
/admin/notebooks/notebookexecution/<path:object_id>/	django.views.generic.base.RedirectView
/admin/notebooks/notebookexecution/<path:object_id>/change/	django.contrib.admin.options.change_view	admin:notebooks_notebookexecution_change
/admin/notebooks/notebookexecution/<path:object_id>/delete/	django.contrib.admin.options.delete_view	admin:notebooks_notebookexecution_delete
/admin/notebooks/notebookexecution/<path:object_id>/history/	django.contrib.admin.options.history_view	admin:notebooks_notebookexecution_history
/admin/notebooks/notebookexecution/add/	django.contrib.admin.options.add_view	admin:notebooks_notebookexecution_add
/admin/notebooks/notebookfeature/	django.contrib.admin.options.changelist_view	admin:notebooks_notebookfeature_changelist
/admin/notebooks/notebookfeature/<path:object_id>/	django.views.generic.base.RedirectView
/admin/notebooks/notebookfeature/<path:object_id>/change/	django.contrib.admin.options.change_view	admin:notebooks_notebookfeature_change
/admin/notebooks/notebookfeature/<path:object_id>/delete/	django.contrib.admin.options.delete_view	admin:notebooks_notebookfeature_delete
/admin/notebooks/notebookfeature/<path:object_id>/history/	django.contrib.admin.options.history_view	admin:notebooks_notebookfeature_history
/admin/notebooks/notebookfeature/add/	django.contrib.admin.options.add_view	admin:notebooks_notebookfeature_add
/admin/notebooks/notebookmeta/	django.contrib.admin.options.changelist_view	admin:notebooks_notebookmeta_changelist
/admin/notebooks/notebookmeta/<path:object_id>/	django.views.generic.base.RedirectView
/admin/notebooks/notebookmeta/<path:object_id>/change/	django.contrib.admin.options.change_view	admin:notebooks_notebookmeta_change
/admin/notebooks/notebookmeta/<path:object_id>/delete/	django.contrib.admin.options.delete_view	admin:notebooks_notebookmeta_delete
/admin/notebooks/notebookmeta/<path:object_id>/history/	django.contrib.admin.options.history_view	admin:notebooks_notebookmeta_history
/admin/notebooks/notebookmeta/add/	django.contrib.admin.options.add_view	admin:notebooks_notebookmeta_add
/admin/password_change/	django.contrib.admin.sites.password_change	admin:password_change
/admin/password_change/done/	django.contrib.admin.sites.password_change_done	admin:password_change_done
/admin/pipelines/pipeline/	django.contrib.admin.options.changelist_view	admin:pipelines_pipeline_changelist
/admin/pipelines/pipeline/<path:object_id>/	django.views.generic.base.RedirectView
/admin/pipelines/pipeline/<path:object_id>/change/	django.contrib.admin.options.change_view	admin:pipelines_pipeline_change
/admin/pipelines/pipeline/<path:object_id>/delete/	django.contrib.admin.options.delete_view	admin:pipelines_pipeline_delete
/admin/pipelines/pipeline/<path:object_id>/history/	django.contrib.admin.options.history_view	admin:pipelines_pipeline_history
/admin/pipelines/pipeline/add/	django.contrib.admin.options.add_view	admin:pipelines_pipeline_add
/admin/pipelines/pipelinetemplate/	django.contrib.admin.options.changelist_view	admin:pipelines_pipelinetemplate_changelist
/admin/pipelines/pipelinetemplate/<path:object_id>/	django.views.generic.base.RedirectView
/admin/pipelines/pipelinetemplate/<path:object_id>/change/	django.contrib.admin.options.change_view	admin:pipelines_pipelinetemplate_change
/admin/pipelines/pipelinetemplate/<path:object_id>/delete/	django.contrib.admin.options.delete_view	admin:pipelines_pipelinetemplate_delete
/admin/pipelines/pipelinetemplate/<path:object_id>/history/	django.contrib.admin.options.history_view	admin:pipelines_pipelinetemplate_history
/admin/pipelines/pipelinetemplate/add/	django.contrib.admin.options.add_view	admin:pipelines_pipelinetemplate_add
/admin/r/<path:content_type_id>/<path:object_id>/	django.contrib.contenttypes.views.shortcut	admin:view_on_site
/admin/sites/site/	django.contrib.admin.options.changelist_view	admin:sites_site_changelist
/admin/sites/site/<path:object_id>/	django.views.generic.base.RedirectView
/admin/sites/site/<path:object_id>/change/	django.contrib.admin.options.change_view	admin:sites_site_change
/admin/sites/site/<path:object_id>/delete/	django.contrib.admin.options.delete_view	admin:sites_site_delete
/admin/sites/site/<path:object_id>/history/	django.contrib.admin.options.history_view	admin:sites_site_history
/admin/sites/site/add/	django.contrib.admin.options.add_view	admin:sites_site_add
/admin/wiki/article/	django.contrib.admin.options.changelist_view	admin:wiki_article_changelist
/admin/wiki/article/<path:object_id>/	django.views.generic.base.RedirectView
/admin/wiki/article/<path:object_id>/change/	django.contrib.admin.options.change_view	admin:wiki_article_change
/admin/wiki/article/<path:object_id>/delete/	django.contrib.admin.options.delete_view	admin:wiki_article_delete
/admin/wiki/article/<path:object_id>/history/	django.contrib.admin.options.history_view	admin:wiki_article_history
/admin/wiki/article/add/	django.contrib.admin.options.add_view	admin:wiki_article_add
/admin/wiki/articlerevision/	django.contrib.admin.options.changelist_view	admin:wiki_articlerevision_changelist
/admin/wiki/articlerevision/<path:object_id>/	django.views.generic.base.RedirectView
/admin/wiki/articlerevision/<path:object_id>/change/	django.contrib.admin.options.change_view	admin:wiki_articlerevision_change
/admin/wiki/articlerevision/<path:object_id>/delete/	django.contrib.admin.options.delete_view	admin:wiki_articlerevision_delete
/admin/wiki/articlerevision/<path:object_id>/history/	django.contrib.admin.options.history_view	admin:wiki_articlerevision_history
/admin/wiki/articlerevision/add/	django.contrib.admin.options.add_view	admin:wiki_articlerevision_add
/admin/wiki/urlpath/	django.contrib.admin.options.changelist_view	admin:wiki_urlpath_changelist
/admin/wiki/urlpath/<path:object_id>/	django.views.generic.base.RedirectView
/admin/wiki/urlpath/<path:object_id>/change/	django.contrib.admin.options.change_view	admin:wiki_urlpath_change
/admin/wiki/urlpath/<path:object_id>/delete/	django.contrib.admin.options.delete_view	admin:wiki_urlpath_delete
/admin/wiki/urlpath/<path:object_id>/history/	django.contrib.admin.options.history_view	admin:wiki_urlpath_history
/admin/wiki/urlpath/add/	django.contrib.admin.options.add_view	admin:wiki_urlpath_add
/admin/wiki_attachments/attachment/	django.contrib.admin.options.changelist_view	admin:wiki_attachments_attachment_changelist
/admin/wiki_attachments/attachment/<path:object_id>/	django.views.generic.base.RedirectView
/admin/wiki_attachments/attachment/<path:object_id>/change/	django.contrib.admin.options.change_view	admin:wiki_attachments_attachment_change
/admin/wiki_attachments/attachment/<path:object_id>/delete/	django.contrib.admin.options.delete_view	admin:wiki_attachments_attachment_delete
/admin/wiki_attachments/attachment/<path:object_id>/history/	django.contrib.admin.options.history_view	admin:wiki_attachments_attachment_history
/admin/wiki_attachments/attachment/add/	django.contrib.admin.options.add_view	admin:wiki_attachments_attachment_add
/api/artefacts/	artefacts.views.ArtefactViewSet	artefacts:artefact-list
/api/artefacts/	rest_framework.routers.APIRootView	artefacts:api-root
/api/artefacts/<drf_format_suffix:format>	rest_framework.routers.APIRootView	artefacts:api-root
/api/artefacts/<hash>/	artefacts.views.ArtefactViewSet	artefacts:artefact-detail
/api/artefacts/<hash>/download/	artefacts.views.ArtefactViewSet	artefacts:artefact-download
/api/artefacts/<hash>/download\.<format>/	artefacts.views.ArtefactViewSet	artefacts:artefact-download
/api/artefacts/<hash>/export/	artefacts.views.ArtefactViewSet	artefacts:artefact-export
/api/artefacts/<hash>/export\.<format>/	artefacts.views.ArtefactViewSet	artefacts:artefact-export
/api/artefacts/<hash>/load/	artefacts.views.ArtefactViewSet	artefacts:artefact-load
/api/artefacts/<hash>/load\.<format>/	artefacts.views.ArtefactViewSet	artefacts:artefact-load
/api/artefacts/<hash>/preview/	artefacts.views.ArtefactViewSet	artefacts:artefact-preview
/api/artefacts/<hash>/preview\.<format>/	artefacts.views.ArtefactViewSet	artefacts:artefact-preview
/api/artefacts/<hash>\.<format>/	artefacts.views.ArtefactViewSet	artefacts:artefact-detail
/api/artefacts/\.<format>/	artefacts.views.ArtefactViewSet	artefacts:artefact-list
/api/artefacts/cleanup/	artefacts.views.ArtefactViewSet	artefacts:artefact-cleanup
/api/artefacts/cleanup\.<format>/	artefacts.views.ArtefactViewSet	artefacts:artefact-cleanup
/api/artefacts/stats/	artefacts.views.ArtefactViewSet	artefacts:artefact-stats
/api/artefacts/stats\.<format>/	artefacts.views.ArtefactViewSet	artefacts:artefact-stats
/api/article-tree/	notelib.views.article_tree_api	article_tree_api
/api/features/exec/	features.views.exec	exec_feature
/api/features/import/	features.views.import_feature	import_feature
/api/features/list/	features.views.list_features	list_features
/api/features/load_notebook/	features.views.load_notebook	load_notebook
/api/features/registry/	features.views.registry	registry
/api/pipelines/	pipelines.views.PipelineViewSet	pipelines:pipeline-list
/api/pipelines/	rest_framework.routers.APIRootView	pipelines:api-root
/api/pipelines/<drf_format_suffix:format>	rest_framework.routers.APIRootView	pipelines:api-root
/api/pipelines/<pk>/	pipelines.views.PipelineViewSet	pipelines:pipeline-detail
/api/pipelines/<pk>/duplicate/	pipelines.views.PipelineViewSet	pipelines:pipeline-duplicate
/api/pipelines/<pk>/duplicate\.<format>/	pipelines.views.PipelineViewSet	pipelines:pipeline-duplicate
/api/pipelines/<pk>/export/	pipelines.views.PipelineViewSet	pipelines:pipeline-export
/api/pipelines/<pk>/export\.<format>/	pipelines.views.PipelineViewSet	pipelines:pipeline-export
/api/pipelines/<pk>/validate/	pipelines.views.PipelineViewSet	pipelines:pipeline-validate
/api/pipelines/<pk>/validate\.<format>/	pipelines.views.PipelineViewSet	pipelines:pipeline-validate
/api/pipelines/<pk>\.<format>/	pipelines.views.PipelineViewSet	pipelines:pipeline-detail
/api/pipelines/\.<format>/	pipelines.views.PipelineViewSet	pipelines:pipeline-list
/api/pipelines/import_pipeline/	pipelines.views.PipelineViewSet	pipelines:pipeline-import-pipeline
/api/pipelines/import_pipeline\.<format>/	pipelines.views.PipelineViewSet	pipelines:pipeline-import-pipeline
/api/pipelines/templates/	pipelines.views.PipelineTemplateViewSet	pipelines:template-list
/api/pipelines/templates/<pk>/	pipelines.views.PipelineTemplateViewSet	pipelines:template-detail
/api/pipelines/templates/<pk>/instantiate/	pipelines.views.PipelineTemplateViewSet	pipelines:template-instantiate
/api/pipelines/templates/<pk>/instantiate\.<format>/	pipelines.views.PipelineTemplateViewSet	pipelines:template-instantiate
/api/pipelines/templates/<pk>\.<format>/	pipelines.views.PipelineTemplateViewSet	pipelines:template-detail
/api/pipelines/templates\.<format>/	pipelines.views.PipelineTemplateViewSet	pipelines:template-list
/api/runs/	executions.views.PipelineRunViewSet	executions:run-list
/api/runs/	rest_framework.routers.APIRootView	executions:api-root
/api/runs/<drf_format_suffix:format>	rest_framework.routers.APIRootView	executions:api-root
/api/runs/<pk>/	executions.views.PipelineRunViewSet	executions:run-detail
/api/runs/<pk>/cancel/	executions.views.PipelineRunViewSet	executions:run-cancel
/api/runs/<pk>/cancel\.<format>/	executions.views.PipelineRunViewSet	executions:run-cancel
/api/runs/<pk>/download/	executions.views.PipelineRunViewSet	executions:run-download
/api/runs/<pk>/download\.<format>/	executions.views.PipelineRunViewSet	executions:run-download
/api/runs/<pk>/logs/	executions.views.PipelineRunViewSet	executions:run-logs
/api/runs/<pk>/logs\.<format>/	executions.views.PipelineRunViewSet	executions:run-logs
/api/runs/<pk>/retry/	executions.views.PipelineRunViewSet	executions:run-retry
/api/runs/<pk>/retry\.<format>/	executions.views.PipelineRunViewSet	executions:run-retry
/api/runs/<pk>\.<format>/	executions.views.PipelineRunViewSet	executions:run-detail
/api/runs/\.<format>/	executions.views.PipelineRunViewSet	executions:run-list
/artefacts/	django.views.generic.base.TemplateView	frontend:artefacts_list
/artefacts/<str:hash>/	django.views.generic.base.TemplateView	frontend:artefact_detail
/create-root/	wiki.views.article.CreateRootView	wiki:root_create
/media/<path>	django.views.static.serve
/missing-root/	wiki.views.article.MissingRootView	wiki:root_missing
/notebooks/	notebooks.views.notebook_list	notebooks:list
/notebooks/<int:pk>/	notebooks.views.notebook_detail	notebooks:detail
/notebooks/<int:pk>/delete/	notebooks.views.notebook_delete	notebooks:delete
/notebooks/<int:pk>/reprocess/	notebooks.views.notebook_reprocess	notebooks:reprocess
/notebooks/upload/	notebooks.views.notebook_upload	notebooks:upload
/notifications/goto/	django_nyt.views.goto	nyt:goto_base
/notifications/goto/<notification_id>/	django_nyt.views.goto	nyt:goto
/notifications/json/get/	django_nyt.views.get_notifications	nyt:json_get
/notifications/json/get/<latest_id>/	django_nyt.views.get_notifications	nyt:json_get
/notifications/json/mark-read/	django_nyt.views.mark_read	nyt:json_mark_read_base
/notifications/json/mark-read/<id_lte>/<id_gte>/	django_nyt.views.mark_read	nyt:json_mark_read
/notifications/json/mark-read/<var>/	django_nyt.views.mark_read	nyt:json_mark_read
/pipelines/	django.views.generic.base.TemplateView	frontend:pipelines_list
/pipelines/<uuid:id>/	django.views.generic.base.TemplateView	frontend:pipeline_detail
/pipelines/<uuid:id>/edit/	django.views.generic.base.TemplateView	frontend:pipeline_edit
/runs/	django.views.generic.base.TemplateView	frontend:runs_list
/runs/<uuid:id>/	django.views.generic.base.TemplateView	frontend:run_detail
/runs/launch/	django.views.generic.base.TemplateView	frontend:run_launch
/static/<path>	django.views.static.serve
